1111111111111
10010000000C1
1010011111001
1P001TE000001
1111111111111
