1111111111111111111
111111P011111111111
1111111011111111111
1000000000000000001
1000000C00000C00001
1100000000000000001
1000111111100000001
1111111C11111000111
1111111111111E11111
1111111111111111111
