11111111111111111111111111111
1000E000000000010000000P00001
10000000000000010000000000001
10000000000000010000000000001
1000C000000000010000000000001
10000000000000010000000000001
100000000000000100000000000c1
11111111111111111111111111111